11111
11P11
11C11
11EC1
11111
