111111111111111111111111111111
1C000100000111C1000000000100E1
111101000001000000001000100001
100C0100C001P1010000011C000001
100001000011111000000001000001
1001000000100C0000001001000001
100001000010000000000000000001
101100110C1011001001000000C101
100C10000C0000001000C111000001
111111111111111111111111111111
